#MAJORS
MAC = "countries/Macedonia.txt"
CAR = "countries/Carthage.txt"
AEG = "countries/Aegyptos.txt"
SUE = "countries/Suebi.txt"
CEL = "countries/Celtica.txt"
GAU = "countries/Gaul.txt"
ILY = "countries/Illyria.txt"
ITY = "countries/Italia.txt"
RMA = "countries/Roma.txt"
KSB = "countries/Kashubia.txt"
SXY = "countries/Germanic_Saxony.txt"

#PIRATES
EYL = "countries/Eyl.txt"
KLI = "countries/Klin.txt"
KTI = "countries/Kriti.txt"
YRB = "countries/Yarib.txt"
#New Israel
NEK = "countries/Nekharot.txt"

#BRITAIN
CYM = "countries/Cymru.txt"

LAG = "countries/Lagrlond.txt"
JUT = "countries/Jutland.txt"
DRK = "countries/Danmark.txt"
NLD = "countries/Norrland.txt"
DUM = "countries/Dumnonii.txt"
CVI = "countries/Cornovii.txt"
TRN = "countries/Trinovantes.txt"
BGT = "countries/Brigantes.txt"
NRD = "countries/Nordanvik.txt"
TRV = "countries/Tarvalia.txt"
ORA = "countries/Oravia.txt"
CTH = "countries/Corinth.txt"
CPH = "countries/Cephalonia.txt"
SYL = "countries/Sylphoria.txt"
CLN = "countries/Carthilune.txt"
SVN = "countries/Soluventus.txt"
THS = "countries/Thalasora.txt"
NVM = "countries/Novemoria.txt"
ESN = "countries/Elysionia.txt"
TGA = "countries/Theogonia.txt"
LBD = "countries/Lombardia.txt"
ALM = "countries/Alemannia.txt"
SMN = "countries/Semnonia.txt"
ANC = "countries/Ancona.txt"
CTA = "countries/Capitanata.txt"
SNO = "countries/Salerno.txt"
MSM = "countries/Molisum.txt"
LGA = "countries/Liguria.txt"
CUN = "countries/Cunea.txt"
PCM = "countries/Punicum.txt"
AZM = "countries/Abbruzum.txt"
MPM = "countries/Montpilum.txt"
KTM = "countries/Kartamaal.txt"
TTA = "countries/Tartessia.txt"
CVA = "countries/Carventa.txt"
OVA = "countries/Olivara.txt"
GDA = "countries/Gadiria.txt"
VDA = "countries/Verdena.txt"
BCA = "countries/Bellica.txt"
NMD = "countries/Numidia.txt"
ASG = "countries/Ashig.txt"
ZLT = "countries/Zilant.txt"
BAT = "countries/Barut.txt"
RYT = "countries/Rytvinia.txt"
VZA = "countries/Verzulia.txt"
GDJ = "countries/Galdija.txt"
PNS = "countries/Pinsk.txt"
VLD = "countries/Vildheim.txt"
OST = "countries/Ostholm.txt"
CPD = "countries/Cappadocia.txt"
AIA = "countries/Alethia.txt"
SLC = "countries/Selucia.txt"
EDS = "countries/Edessa.txt"
CMG = "countries/Commagene.txt"
JRD = "countries/Jordan.txt"
HEL = "countries/Heliopolis.txt"
ALR = "countries/Alarion.txt"
TBZ = "countries/Tabrizia.txt"
AKB = "countries/Ashkabadis.txt"
LCO = "countries/Lecco.txt"
AVN = "countries/Avellino.txt"
BVE = "countries/Benevento.txt"
CTZ = "countries/Catanzaro.txt"
DDA = "countries/Dardana.txt"
PSC = "countries/Pescara.txt"
SZA = "countries/Serenza.txt"
KHU = "countries/Khuzestan.txt"
TCE = "countries/Thrace.txt"
INA = "countries/Ionia.txt"
ATD = "countries/Anatolides.txt"
ODR = "countries/Odrysia.txt"

#Gallic Releasables
CNT = "countries/Carnutia.txt"
PCT = "countries/Pictonia.txt"
ARV = "countries/Arvenia.txt"
LNN = "countries/Lingonia.txt"
SNN = "countries/Senonia.txt"

#Albion Releasables
GDD = "countries/Gododdin.txt"
ELM = "countries/Elmet.txt"
RHG = "countries/Rheged.txt"

#Formables
ABN = "countries/Albion.txt"
BRN = "countries/Brennonia.txt"
SKL = "countries/Skaldasker.txt"
MGN = "countries/MagnaGraecia.txt"
KEM = "countries/Kemet.txt"
JUG = "countries/Jugoslavia.txt"
SEV = "countries/Severoslavia.txt"
SLV = "countries/Slavia.txt"

#Egypt Releasables
MMP = "countries/Men-Nefer.txt"
TNU = "countries/Tehenu.txt"
KUS = "countries/Kush.txt"
IRT = "countries/Irtyu.txt"